11111111111111110001
11111111111111110111
11111111100011101111
11111111031100000111
11111111011131110111
11111111000000000111
11211111111111101111
11111111111111101111
11211111011111101111
11111111011111101211
12111111011111101111
11111111011111101211
11110000000000001111
11111111111101111111
11000111111101113111
11110000001101113111
11111111100001113111
11111111111111111111
11111111100001113111
11111111111111111111