11111111111111111001
11111111111000000011
11111111111011111111
11100000000011111111
11111111101111111111
11111111101111111111
11131111101111111111
11111111101111111111
11111111101111111111
11111100000000111111
11111111111110111111
11101111111110111111
11101111111110111111
11101111000000111111
11101111110111111111
11101111110111131111
11301111110111131111
11101111100111111111
13100000001111111111
11111111111111111111
