11111112111111111101
11111111111111111101
11111111111111111101
11111111121111111101
11111111111111111101
11111111111111111101
11111111131111111101
10111111111111000001
10111111113111011111
10111113111000011111
10111110000011111111
10111110112211111111
10111110111122111111
10111110111111111111
10111110111111141111
10000110111111111411
11110110111311111111
11110000131311111111
11111111111111111111
11111111111111111111